S...#########################################################
......#..#...........#........#..#........#...........#.....#
#..#..#..#..#..#..#..#..#######..####..#..#..#..#..#######..#
#..#........#..#..#..#........#..#..#..#..#..#..#..#..#.....#
#..#..###################..####..#..####..#..####..#..#..#..#
#..#...........#........#..............#..#.....#..#.....#..#
#..####..##########..################..#..#..#..#..#..#..####
#..#.....#..#..#........#..............#..#..#..#.....#..#..#
#######..#..#..#..#######..#..####..####..##########..####..#
#..#........#..#........#..#.....#..#..#..#..#..#........#..#
#..#..#######..#..####..##########..#..#..#..#..####..####..#
#...........#........#..#..#...........#.................#..#
####..####..#..####..####..#..####..################..####..#
#.....#..#........#..#..#.....#..............#........#.....#
####..#..####..#######..#..####..####..#######..#..#######..#
#...........#..#........#..#.....#...........#..#..#..#.....#
#..####..#..##########..#..####..##########..#..####..#..#..#
#.....#..#........#.....#.....#.....#....................#..#
#..#######..#..####..#############..#..#..####..####..####..#
#.....#.....#..#.....#.....#.....#..#..#..#.....#.....#..#..#
#..#######..#..####..#..####..#######..##########..#..#..#..#
#..#........#........#.....#........#..#..#..#..#..#..#.....#
#..####..#############..####..#######..#..#..#..#######..####
#.....#.....#..#..#...........#.....#...........#..#..#..#..#
#######..####..#..#######..####..#######..####..#..#..#..#..#
#.....#.....#..#..#..#..#.....#..#.....#..#..#........#..#..#
#..#######..#..#..#..#..#..####..#..#######..####..#######..#
#.....#...........#..#........#.....#.......................#
####..##########..#..#..#..####..#..##########..#######..####
#..#..#........#.....#..#..#.....#..#.....#........#........#
#..#..####..####..#..#..#..####..####..#..#..#..#######..####
#..............#..#.....#.....#........#..#..#.....#........#
#..####..####..#..#..#..#..####..#..####..#..################
#..#..#.....#.....#..#..#..#.....#..#..#.....#..............#
#..#..#######..##########..####..####..####..####..#..#..####
#..#...........#.....#...........#.....#..#.....#..#..#.....#
#..#######..####..##########..#######..#..#..#..#######..####
#..#........#..#..#...........#..#........#..#.....#........#
#######..####..#..#..#..#######..####..#..####..##########..#
#.................#..#.................#.....#..............C
#############################################################